# # # # # # # # # # # # # # # # # # # # # # # # # # # # # # # # # # # # # # # # # # # # # # # # # # # # # # #
 # # # # # # # # # # # # # # # # # # # # # # # # # # # # # # # # # # # # # # # # # # # # # # # # # # # # # # #
 # # P #                       #                   #                                               #       # #
 # #   #   # # # # # # # # #   #   # # # # #   #   # # # # #   # # # # # # # # # # # # # # # # #   #   #   # #
 # #   #       #   #           #   #           #               #       #                   #   #   #   #   # #
 # #   # # #   #   #   # # # # # # #   # # # # # # # # # # # # #   # # #   # # # # #   #   #   #   #   #   # #
 # #           #   #               #   #           #       #               #           #       #   #   #   # #
 # # # # # # # #   # # # # # # #   #   #   # # #   #   #   # # #   # # # # #   # # # # # # #   #   # # #   # #
 # #               #               #           #       #       #       #       #       #       #       #   # #
 # #   # # # # # # #   # # # # # # # # # # # # # # # # # # #   # # # # #   # # #   # # #   # # # # #   #   # #
 # #                   #       #               #               #           #       #       #           #   # #
 # #   # # # # # # # # #   #   #   #   # # #   #   # # # # # # #   # # # # #   # # #   # # #   # # # # #   # #
 # #               #       #   #   #   #       #   #       #       #           #           #   #       #   # #
 # # # # # # # #   # # #   #   #   #   #   # # #   #   # # #   #   # # # # #   #   # # # # #   #   #   #   # #
 # #   #       #           #   #   #   #           #   #       #   #       #       #   #       #   #       # #
 # #   #   #   # # # # # # #   # # #   # # # # # # #   #   # # #   #   #   #   # # #   #   # # #   # # #   # #
 # #       #               #       #   #                   #   #       #   #           #   #       #   #   # #
 # #   # # # # # # #   # # # # #   #   #   # # # # # # # # #   # # # # #   # # # # #   #   #   # # #   #   # #
 # #   #           #   #       #   #   #                   #       #       #       #   #   #       #   #   # #
 # #   #   # # #   #   #   #   #   #   # # # # # # # # #   # # #   #   # # #   #   # # #   # # #   #   #   # #
 # #       #       #       #           #                           #           #                   #     . # #
 # # # # # # # # # # # # # # # # # # # # # # # # # # # # # # # # # # # # # # # # # # # # # # # # # # # # # # #
 # # # # # # # # # # # # # # # # # # # # # # # # # # # # # # # # # # # # # # # # # # # # # # # # # # # # # # #